3
5
3002000205
3100020010
3002210020
3100201010
3001010002
3111001012
3332420505
3111001012
3111031012
3332420505