3333333333
3100020013
3002210023
3100201013
3001010003333
3111333311123
33323--303333
3111333313
3111031013
3333333333